{
	"Name": "MainScene",
	"TimeToVictory": 30.0,
	"SceneLayout": {
		"Legend": {
			"*": {
				"Type": "Wall"
			},
			"+": {
				"Type": "StoneWall"
			},
			"F": {
				"Type": "Flag"
			}
		},
		"PositionMarkers": {
			"E": {
				"Type": "EnemySpawn"
			}
		},
		"Content": [
			"+++++++++++++++++++++++++++++",
			"+ E                        E+",
			"+ +++   ****     *****  +++ +",
			"+       * E*     *   *      +",
			"+       ****     *   *      +",
			"+          *     *   *      +",
			"+       ****     *****      +",
			"+  +++                 +++  +",
			"+   E       *   *           +",
			"+   *   *   *****   *   *   +",
			"+ + * + *   *****   * + * + +",
			"+ + * + *           * + * + +",
			"+   *   *   *****   *   *   +",
			"+           *   *           +",
			"+           * F *           +",
			"+++++++++++++++++++++++++++++"
		]
	}
}